SENEGON	PEPINA
BAAS	GELSOMINA
BABS	TRUC
COVINDASSAMY	VLADISLAV
KHOULA	TIARA
PABISIAK	GAIT
PAUNER	YAKUB
LETTERMANN	JAHMA�L
CREQUER	NIRUJAN
WAFFLARD	YEMI
LAGARRUE	MAILYNN
CLAUTEAUX	YVAN
MAUDIN	SABBAH
PERACHON	KADJIDIA
MILS	FLORINDA
DEBERGHE	UGUETTE
BOUZEBIBA	LOVANA
PANASSIE	ABDUSSAMED
DEMUYNCK	MICAELLA
RODOLAUSSE	ILYASSINE
REGNAUDIN	NATAEL
BEAUDESSON	ELINKA
FRANCHEMICHE	MODESTINE
BRAZO	KEIRA
PIMPIN	AROON
KONEFAL	YOUWEN
FORDOXEL	FATIM�
COLNAY	GORETTE
BOURGETON	SAYRA
JORRE	ROUMAYSA
DEMILE	AHAD
POISAT	NADJIMA
NGUYEN VAN HO	SHIRELLE
BALCON	GUILYANN
ICHOU	MARIE-ANNE
BREERETTE	XABIER
SOUPRE	A�SSETA
AIT LAHCEN	FRANCINET
FALFERI	JANIQUE
SECEH	WIDED
BALANT	Y�NA
RIALLANT	DORITA
DEGUELLE	ZINAR
DESLOT	CANAN
PRESSOIRS	MADJI
DUTHY	DJALLEL
ZAMPAGLIONE	LATTIFA
DE LA HAYE SAINT HILAIRE	LELIA
DOUANE	LOUIS-CL�MENT
SCHIEFELBEIN	SAVANNA
JULVEZ	MARIE-LUCE
DAOUADJI	EMERY
SEREUSE	AKIL
BERKAINE	JADA
BRIGAUDEAU	NOURRA
MILARDI	DILYS
BARDIAU	SHIRYNE
TRENADO	IBRA
LUGIEN	CLOUD
PUIGVERT	L�LIE
MERAUD	MARIA-ALICE
AMABILE	GA�TANNE
LECAPITAINE	SAYED
PEALA	SILLIA
MAISONNIAL	LA�TITIA
TANCHE	PERLINE
MURU	KALVYNN
SOLECKI	SEKOU
JANECZEK	KAMILIA
PIGNONE	M'BALOU
BETAT	MAYBEL
TREPAGNY	SALEM
MOUFLIN	MELEANE
PEZEYRE	ANNE-ASTRID
LE TIRANT	ANUAR
LAMOURY	CHARLES-ALEXIS
COGONI	TAMER
BELLERINI	JEAN-MATHIEU
LECONARDEL	SANTINO
THEVENAUT	LAKSHANA
DESBOS	THIJS
FORGAS	LILWEN
GIXE	JOANY
ETHEVENIN	HAMARA
VORBURGER	HEDDI
PALAGOS	MAX-ANDR�
ANGAMA PETCHY	NAOMA
GAZZETTA	MATTIAS
ASSASSA	AGRIPPINE
HEGELEN	WACIME
SCHEITT	STEFAN
HEIDERICH	LISEBERTHE
ARCHAMBAUDIERE	BOLESLAS
DI LUCA	AUREL
LE BEGUE DE GERMINY	MERIADEC
CHOURLIN	ELISHA
BORTELLE	LEYSON
LECAMP	ASTERIE
CURIUS	ALEXINE
MANCAIS	LO�ZA
CAUVEZ	NYDAL
RENTE	GRATIANE
DIFFORT	MA�SSAE
BALANA	ELDA
PIMPEC	HOSANNA
TREFFEL	HENDRYCK
CAPORALI	MESUD
GROUIN	ANJALIE
LE DREVO	YOANIS
LECHOT	FELICIE
CHOMEL	MARIEVE
EPINAT	NESRIN
ULMET	ISHMAEL
GIREME	DAHAB
MEILLOUIN	PAVLE
MALEVAL	GULDEREN
CAZARUC	JUSTINO
LOBBESTAEL	DJULIO
GOUILLOT	PAUL-HUBERT
CUNNINGHAM	DILANI
BEAUBOIS	MEILIE
SIRVENTON	SOURAKATA
VIGOUREUX	SIA
BOXLER	ANNA-MAE
TAMBOITE	RUBEN
MACQUAIRE	NEOMIE
GESUALDI	VLADAN
PUSSIN	MOSTEPHA
CHARDON DU RANQUET	JAINA
TUECH	GODELIEVE
ROUGEAULT	OSSAMA
VERNIAUT	FAHRID
AFKIR	ELLYN
SAJA	M�LISSA
ROLEZ	SOAM
PASQUERAULT	LUC-ANTOINE
GEERSSEN	FRAN�OIS-ALEXIS
PARVAUX	JAOUED
SAINT SAUVEUR	SEMIR
VISCONTINI	SAKINAH
PYLE	IYAM
VIGNACOURT	JUAN-LUIS
BOZON	NEVAL
BENDAHOU	LIDYA
AOUALI	RUGGIERO
THIEULLEN	LILOUAN
RIZO	AYOUBE
BOUKHTOUCHEN	KATIA
FATTORI	JASSEM
NEBON	HASSINA
CUISY	LHASSA
COUTEM	NO�LLINE
MIGNERE	ORESTIS
FEROUSSIER	SHUN
DUCHAUFOUR	OUIAM
PIERRICHON	VAL�RIO
BRUNISHOLZ	DILBER
BIELAWSKI	MOUHSINE
VEISSEYRE	RAY
VEUX	LANGE
CHAZELAT	ALEKSEY
VANSTEENBRUGGHE	GHJULIANU
DELORIS	ELIZA
LAVANNIER	ROKAIA
LAOUST	L�ONY
PERINI	ANDRESINE
DOMBEY	LUPIN
BORGER	EDWARD
REUS	ASMINA
WALLETH	NURSENA
HAERTELMEYER	MAEL
CORBANESE	LOUIS-ARMAND
AILLOUD-BETASSON	CHADI
EL BOUDALI	ERWIN
BRATTI	DONY
POVEROMO	AYANAH
LAHARIE	YAHAYA
BAUVAIS	JEANNOT
MEILHEURAT	KATALYA
GARREJAT	NOANE
PAMISEUX	ALEXANDR
DESIRESSE	LONGIN
ANNELOT	HACHIMIA
MAINIL	NE�LAN
HENDRIX	HAIK
ELIND	ABDEREMANE
HEBBE	LYAS
EIFFES	ADLEY
MICAND	ARTHY
LACAL	MANU
PODAVINI	ABDELRHAMANE
JAVAUD	SIDJY
MORNAS	NOLWENNE
DEWEES	ELHADJE
FARHANE	GUERCHOM
BOUGRAIN	EREEN
LEFAUVEAU	SHERYL
GAUVAL	LOUIS-DANIEL
POSSETY	ANAHIT
CHAMBEY	GHJASEPPU
MIRC	SALIFOU
BOUCHIKH	HECHMI
NATHANSON	LIZ
CARDES	IRENEE
PIOLIN	VANNY
SENTEIN	AISOSA
MARZA	MOUSLIMA
DE SAINT ESTEBAN	MARTINA
CHAVIGNON	JEMS
BOURZAC	AURE
HONG	ALEM
FOUILLOUZE	ANTEO
PLUMEY	LHEA
RYCKBOSCH	HOUSNI
DUMONT SAINT PRIEST	GLAUDIA
TALAL	WISSAME
COULOIGNER	RAWIA
URPI	CONOR
MOUROUGUIN-SOUBOU	DAMIANE
LAPRELLE	WELID
BOBECHE	MEIDI
THAVAUD	DANYAH
PONNELAIS	LIVA
JUTAND	YERIM
JALA	JOSETTE
JEGLOT	EZIO
FENOYER	AILYS
SCHIMPFF	CHOCHANA
HOCE	KABA
BARTOCCIONI	YLHAN
BOURENS	RINED
MESPLET	AXELLANE
FARRET	ORHIANE
SOUNDROM	ABDELLAH
SALVIANI	LEONCIE
DUZANSON	LAULA
VISSUZANNE	JULICIEN
COUVRIL	ANAISSE
GUIZ	GLWADYS
PERUT	FAKHRI
LONGRE	MIHYA
LEGARDINIER	SEDRIC
VEROUX	CARLU-MARIA
DESMOUSSEAUX	KYANNA
VILLARON	SHADI
HALLEZ	ANNE-CAROLINE
PILLENIERE	A�VY
THILOT	SOULTANA
KHERRAZ	ARABELLA
MONTIL	SORIBA
JEHIER	IHCENE
YAPO	OZDEN
CORTEZON	MEKKY
DURRAULT	HEDWIG
TRUFAUT	ALIZE
MECHTAOUI	AHCENE
LARDEUX	KRYSS
GUERCHAIS	M�LYNE
TINTURE	ROMMY
ANNANE	ESRA-NUR
SZCZYRBA	TAYLEUR
DRUTINUS	SHANYA
DESCELIERS	ISORA
ABBI	SH�RYNE
STERK	JEAN-WILFRID
HEBINGER	GWENDALINA
CRAYSSAC	HASHIM
BONNAFOUS	ELZ�AR
TAUPIGNON	SOLEANE
HIERON	AYYUB
CAUHET	MIMOSETTE
CHRISTON	LEILA
LINDEMANN	DJITY
COLOM	NICOLAS
GUIRAUTE	MARIE-EVELINE
FRELING	ANGHARAD
ROMEA	ELAM
BITTERWOLF	ROSE-MARTHE
DEJONGH	JOURI
LE STANG	JOHEN
ANASTHASE	ALBERT
DIMONT	NIMET
FOULBOEUF	AGOP
CHAPAS	ANIC�E
SARRES	SELSEBIL
PINTORI	GALAAN
CHARCONNET	ANCUTA
GILARDONI	LIZANDRA
DECLE	RASLAN
AGNOUX	BANGALY
BERDE	LAURYS
VILAIS	YLLIES
TROTOT	AIYANNA
CAVALLIN	JOHANNICK
ROEDELSPERGER	ANA-LUCIA
DUNAIME	DAHLILA
HAENI	THYNO
DEPRELLE	ODALYS
RIOTHON	MAGUELONE
POPOTTE	HENDRIK
RIQUET	SAHAROU
QUATRAVAUX	MAAZ
OFCARD	NAGIB
CLEAR	ESSAM
DAROCHA	FRAHIM
REMY DE CAMPEAU	CHAZA
BEAUJEAN	KATHIANA
TELL	BERKEN
PURNELLE	GULBAHAR
MIECAMP	CONSUELA
CRABERE	SEBAN
BONTILLOT	BRENAN
LATTAQUE	ANNA-LOU
MASON	KESSIM
SACAREAU	STEPHY
HERNY	BUNA
BOSGIRAUD	PIETRO
DANETTE	�INAR
MALEZE	ANACLET
RANDRIANARISOA	DRIS
GREAUD	PAOLIG
KOWOLIK	FATINA
TSCHANZ	ABDESSALEM
LAIMANT	ADJIA
SCHWENDER	YDA
BREVOT	DJANETTE
BARALDI	SAHLI
COLLOREC	MIRABELLE
ILIK	LAURALINE
LOUMES	FATIHA
TIMIN	KEVSER
PASQUIERS	AMENDINE
PETTEX-SORGUE	CYPRILLE
COUSTEL	NELSIA
DEDUN	TIA
AUDRAN	MARINA
TOURRAILLE	HEJAR
LARRIVAL	RENNY
LUPOLI	KLARYS
DEMUS	FRANCESCA
GUIFFROY	MURYEL
KOEHRLEN	REDJY
GALAINE	TALLY
HARQUET	JANESSA
BURTIN	BRIELLA
FARRUGGIO	QASS�M
PINARDEAU	HOUYEM
POLIAKOFF	ELOHANE
BLAIRON	DILHAN
GOBAT	SORENZA
BALESME	MEG-ANNE
BONVINI	IN�SS
MEBERBECHE	SCHEERAZADE
PADEIRO	ISMAYL
LEVREAUD	LEEVAN
BISCAYLEUX	VERENA
MOGHRAOUI	LAALIA
GOBIL	MAGNUS
BREBION	KOBA
KEMPERDICK	RON
DEDINGER	VALENE
BENAKOUCHE	LUCENZO
NIVOIT	DAYANI
FERRERES	AZELYS
REVELAT	KLEO
MOERENHOUT	ANDREA
STREHL	MALIKE
PIRRAULT	ZYON
PARSEMAIN	SUHANA
NARAININ	ATHANAISE
BENION	TALLIA
LUGASSY	KAOITAR
LEONARDY	LUBA
PALESI	BERNADINE
LEHNHARD	NOELIA
DALAUDIERE	MOHIB
FOUQUERAY	GYPSIE
MONTAILLARD	HOULEY
ANTINOUS	VEDRAN
COUTANT	SUANA
VILLARBU	KATHIANA
JALOUNEIX	JA�LAN
MAQUARD	JOHAR
PINAI	KRISHAN
FASCIAUX	LAAZIZ
KINDER	ALVYN
RONSSERAY	KEZYA
GUILLAUT	YOUSSRI
THOULON	ARES
MAGAT	G�VEN
MOUAISSI	CHABANNE
CALONNE	HAMANI
VIOUJAS	JIOVANNI
BESE	FADWA
TEMPERAULT	JOLIE
BURS	JOANEL
CONTENSOUX	ATHANAISE
FOURATIER	SALSABYL
FUCHES	K�ME
ARPOULET	SELINE
PENNACCHIONI	KHADOUJA
CARIGNY	STIVENS
VERDAINE	DIMITRIOS
PETTAVINO	KE�SSA
VIERSOU	ANTH�A
LE FLOC H	ARTHUR-LOUIS
LE NOZER	NATSU
DESMERY	BERTHELINE
AYOUNI	MOUNISSA
GERY	AKHIM
MERGER	KLAUS
RINOLDO	MELYNN
ORBIE	EDIM
FEKNOUS	MILA-ROSE
BOITREAUD	LILI-ROSE
GOUILLET	STANA
BARDAUX	HALIYA
DELLY	HADIA
SALMERON	NIZARE
MENANT	CARLENE
GOUTELLE	JEAN-JUNIOR
TINTORRI	KHEIRON
MAZIOU	LAUVIAH
SEMENTA	ALIAS
PAGIN	MA�LYNNE
CURVERS	MARIE-GUY
DEROT	ALVIN
CROXOO	YENDI
LANOISELEE	SHAINNA
BOUTHINON	FADIHA
DE-VOS	HELENE
JULVEZ	SAINTE-CROIX
AVIGNANT	LOQMANE
BEORD	NAGIHAN
THARAN	NEVAN
LEIBOWITCH	KANIKA
LOMELET	LOUHNA
SEIDLITZ	AMATH
GERGEN	LIETTE
NESMON	SABER
DEGOUILLES	SCARLETTE
OUAICHA	AUBIN
LEUREUX	MAROUA
RESTOUL	MORJIANE
SCHEIWILLER	ROUCHDA
TILLEUL	ANGUERRAND
DHAOUADI	AMADI
DOMINICZAK	MAXIMILIE
AGELOU	SAINT-JUST
TRAPU	KEMAEL
DOMAINE	RESHMA
DAUDOIS	SHAFI
DESHONS	LAOUNI
MEGUELLATI	SANAD
MOTTARD	SIWAN
CHAUPRE	SOL�NA
ESCALLON	ALEM
TUFEKCI	FRAN�OIS-FR�D�RIC
CHATRON	REIS
JEAN-LAMBERT	GENNARO
POULAIN	MOHAMED-ADAM
OUHADDA	DJAYAN
LORRILLIARD	AMORY
NEGRO	JAISON
PEYE	ADHIRA
COUTIL	BERTRAM
ALASNIER	SOADE
HEURGON	SILVETTE
MITELHEISER	MOHAMED-ALI
FRIGOULIER	ORELIE
CARCANAGUE	PAMELLA
GOULIE	EVANIE
FERRAIT	JOAHN
HERBACH	JUNAID
ANSELMETTI	ETHANE
HENIN	TAMIA
KANAT	ANDR�AS
DE RASILLY	ST�VE
MATHOURAIS	MAY-LINE
BATALLA	WASEEM
LASRY	ABDERRAHIM
EYTIER	CLEMENCEAU
HANDEL	MARELLA
VANDROT	GIULLIA
COULLOUETTE	AUREGAN
CABIANCA	MEHREZ
ESPINOUSE	JEAN-MARTIAL
GOUESMEL	IWEN
VAN BOURGOGNE	HONORETTE
PALLOURE	MARGARETE
BERTRAUD	EDHEM
LAMBRECHTS	RAOUL
GOURRIET	AUBERIE
HERBIL	CHAKER
GINESTES	FLAVIA
FIDIER	SHAHZAD
DUTEILLE	IVEN
GRUNERT	KAOUTER
DEHACQ	FIORA
JAYET-LARAFFE	TYANNA
FETIVEAU	DAPHNA
POUZOLLES	MILANE
BRAGANTE	GRACE-EMMANUELLE
WOLANSKI	AHMED-ALI
COSTERG	RUMAYSA
CHAVIN-GAZALIER	YUBA
PEDRETTI	CYARA
SORANO	YANN-OLIVIER
FOURE	FERIAL
POUSSEL	YVIE
SERVIES	CARLU-ANDRIA
LIRONDIERE	DUSTY
PAGEOT	TIPHENE
MATEUF	ELEONOR
METTRE	SHEIKH
HIERRO	THALLYA
BRIEUX	DHELYA
TOULIN	DOV
DALY-ERAYA	EDHEN
DAUVILLE	FRANKIE
PARI	CHRETIEN
PAVEGLIO	NASSABIA
GRATTIERI	MARGAUD
COUFLEAUX	ART
MAGNOL	DAVIS
COURBET	JAMELA
DELOOS	FALCO
MNEMONIDE	MEZYAN
COLBEAU	JESSY
LE LUHANT	DI
KERLOC H	CELDRIC
LA CORTE	HO�L
MIAZGA	ANAICK
VALLCANERAS	LIJANA
TRESDOI	MAREME
DALLANCOURT	LOUJAIN
BERNAERT	CYRIANA
BANQUART	MAYTE
GOULIAN	CL�LIE
LEBOITEUX	NAMORI
LICART	R�JANE
DUPON	LAIS
DEHOURS	SHEIKH
CHAILLIER	ELOIZE
D OLIVEIRA	MOHAMED-REDA
LARMONIER	TAIBA
VENTURINI	GENTILLE
IRION	LAYSA
FREUSLON	EDENN
SAFFON	KAELY
THYMEUR	ANDRIA
BERNELA	LAURY-ANNE
CATTANI	DELCY
CULERRIER	ONESIME
SAMELIN	OLIVETTE
LALFOND	EYLEM
PIZZIGHINI	KAYSAN
PENNEC	LAURANCE
LE TOULOUZAN	JOULIANA
DESANEAUX	M�LUSINE
DOUAY	ARYANA
MANNESSIER	YONNICK
AHAMENDABURU	ALDJA
RICATEAU	JULO
CHIARUGI	NESSA
BALADDA	ASHOT
METGE	ADZO
DIEDERICHS	SIBELLE
MERLAN	THAO
LARAIN	SADJIDA
BIECHER	JA�LY
DEBOUTIN	ABDULKADIR
ANAMPARELA	A�NA
BRISMEUR	SALOMEA
LEMERET	TIFFENE
KARAGULMEZ	ELHABIB
FOUQUAULT	ARDIANA
BENTABERRY	ANNE-LAURE
GARGALLO	HADY
GOUMON	OCTAVIE
ZERKAOUI	ALIKHAN
CRUMBACH	AGNAN
BULFONE	SYRIANE
YAKOUB	MINE
MANDILE	ANNE-LORRAINE
TRAVERE	WISDOM
LE LUYER	KHALISSA
COUSSART	GRICHKA
BOUQUIGNAUD	ANDY
LEPEU	ROSINE
COSSONNEAU	LAURELLE
VELUDO	DIOULA
CLAUSELL	ENNEMONDE
HOURSON	HERMANE
CRAPANNE	GHARIBA
MALUGANI	NOY
DEHORTER	SAURIA
WEINGAND	MAZLUM
JESER	DORA
BENNACER	SANA
NOUETTE	SANJEEV
TAGUELMINT	KHEMARA
BOITEUX	MADJIDE
GIGUELLE	YSMA�L
DAL ZOTTO	MOMEN
VERCLYTTE	LIONELLA
LEPY	DEIRDRE
MEULLENET	PIERINE
FOLKERT	ALONZO
HOPPLER	C�LIO
MEMOLI	LAURENCIE
MALAFOSSE	MARYSOL
GOBLOT	HANANN
MASCHERETTI	MARIANGE
GOTELAERE	NAOKI
KERDONCUF	JOACHIME
SERVANS	HAIKAL
SEBAT	VAITE
MAZOUJI	DOLLY
VAREILHES	SIRAT
RUBAN	FILIPO
BATIME	HASIM
HOMMES	ANTHONYN
LADROUE	MACKENZIE
RUEN	KAILLA
GERTHOUX	CHA�D
LECLOUX	MAGDELAINE
CONSOLO	JERIEL
COTTES	L�NA
DU PONT DE ROMEMONT	RIDHWAN
DAHBI	BIENAIME
FLANZY	ASHVINA
ESPEU	SINDBAD
KASSAS	SANTIANA
XITRA	NELCO
TABAGLIO	AGN�S
TRUFFAUX	KEONI
ALPHONSO	GIANY
FARIGOULE	SEVERIC
OSTERNAUD	HINAYA
GADEMER	SUNIL
DELETRAZ	NADI�GE
DEYE	SOUADE
ZANETTE	IMAYA
MERGOIL	ISMAIEL
CUQUEMELLE	JEAN-CYRIL
KADDOUR	CONAN
IDLAS	MOKTHAR
ZURAW	FLOYD
LEMARECHAL	DELISIA
KOSSI	SADOU
KEMACHE	BASILIE
SURVILLE	AMADY
MARIAC	BENYOUNES
TREBUGET	REYANN
FERROVECCHIO	IS�A
BARBUTO	NEOMIE
LE RUZ	YUNNA
ROGASIK	SERAPHINA
ANGELY	BERNADETTE
TEMMERMAN	ESME
ORVAN	FATIMZOHRA
FOURGOUS	HOA
LEJAMTEL	MALOUNA
LAGAS	NAILAH
BRIATORE	KENZA
ANSELME-MARTIN	NADHIA
TROVO	SWANIE
BERNIOLLES	ABDERAMAN
BERNAS	LEYO
DELUZARCHE	SOUM�YA
BOUJON	IDOYA
POURCHASSE	LA�TITIA
L HERMITTE	ROJIN
FRALEUX	MARIELA
PEINOT	SKYE
TRUCHELUT	ZUBIDA
SUBIRADA	BEKAYE
CORCKET	PHILIDOR
GONSIOR	JERIEL
LANGLAIS	BANEL
COMELLA	ROSANNE
HOCK	NALYAH
MONTEFUSCO	KRISSY
GRAFFIADE	MARIA-S�R�NA
FANIA	ANNAIS
GRIFFAULT	PIERRE-YVON
MIROUEL	LUNA-MARIE
HERTEREAU	GIENEK
MARENCHINO	ABBYGA�L
GUILLARMO	SIMA
SALVEZ	JIH�NE
DONI	ORLANE
DU POUGET	ZAIRA
GUERMACHE	JACQUES-HENRY
DJERFI	MARIA-PIA
VANN	NABILAH
CHOUANNEAU	ST�PHANE
BETREMIEUX	CHAMSDINE
EPITER	LOREDANE
NAFFETAS	GEORGELINE
DECAMBRAY	PIERRE-F�LIX
ETTORE	NOUMAN
TAUTIL	INSAF
FONTANEZ	TAHITOA
PANERAI	RABIRA
STANISLAWIAK	NELSY
KOSE	OUSSAMA
KAIKINGER	VICENTA
HACHEM	BILLIE
CINEUX	HOULEYMATA
CHAYROUSE	JULETTE
HUILLE	KEYNA
KUNG	JOUDI
DESFRENNE	GHISELE
PETIG	GAULTIER
BELVIGNE	ATHANA�L
BELBOUAB	SCANDER
THEILLARD	ODELINE
DESCOMBES	PAUL-ANDR�
BERGOEN	MAKSYMILIAN
CORMANN	ELAMINE
BLANCHIS	RAFAELO
LETANT	MIHAELA
IACONE	PHILLIP
CHARLEYS	ELLAH
SEBAUT	NATY
HAYET	ESSIA
CHABRILLAT	HENRIO
SALUDES	S�RGIO
TIENE	SOULEIMEN
SIGNORI	ZA�M
ARBOUILLE	BLONDINE
KITTEN	LYLY-ROSE
GALZY	MAWEN
LEGATE	AZEMIA
PEYREIGNE	OCTAVIO
GARRAULT	HASSENE
ABDENNEBI	DANI�LE
MADIEC	AELIS
CHELLAOUI	JEANNYNE
AKOUKA	CYLLIA
TROUTTET	OGUZHAN
L'ORPHELIN	DJODIE
LOZIER	DARI
FERNANDES	PRINCILLIA
DEBREYER	ILIANO
PELESTIN	MENA
SALAGE	MA�SSA
RAQUI	ANDREANNE
GOTIN	ELVYRA
GRANGETEAU	MATH�YS
BOURRAN	ANNIC
DOUCELANCE	B�N�DICTE
SELE	MENARD
LEGOU	LO�G
GRAMMOND	A�ANA
DI BITONTO	DAFINA
TIBERE	STEVEN'S
VAGUENEZ	KONOR
DETRAYE	NAYTON
NIAF	VAN�SSA
KLOUCHI	FARELLE
BEROS	GAMILA
DA SILVA COELHO	HOULEY
MENICHETTI	YAKARE
KETFI	YLIAN
PERCEVAULT	KYNAI
BEUGNIEZ	JAHNIS
LESTIBOUDOIS	KAFIA
GIGOT	IWENN
FOLLEAS	HAFIZ
ROMIEUX	DAVENS
LEFELLE	MARIE-ELOISE
LEMAISSI	LEISSA
LE GRAND	ABELARDO
BEUGIN	LYWENN
GAGOUD	SORINA
LIRONCOURT	ALAIA
SCHLUR	KA�LAN
MARGIRIER	NARJISSE
NICOLLIER	YOUGOUDOU
BOQUILLARD	HIMAD
JAFFRET	C�DRINE
COUBEL	ISABELE
OLIJNIK	GUALBERT
BACCOU	NEIJMA
IVAL	JANNIS
DUQUEROIS	KHEPHREN
SASSINE	CAMUS
GUESNEUX	MENAHEM-MENDEL
SOUMAGNAS	JEMAEL
SALIS	PASCALINO
TRESSAUD	DIMYTRI
GUINDER	DIOGOU
CRUZ	K�YAN
HANRION	LEYTON
EL HAFIDI	SANKOUNG
ETENNE	SOULA�MANA
BRUMAN	MARIA-JOAO
JEAN MARIE	LIBERATO
BOUTRY	INDIANA
MALHOMME	FRANCISQUE
AMELOOT	S�LENE
LAZIZ	ARDA
DE HAAN	MOHAMED-BACHIR
BERTHUY	NATASCHA
ARNAULD DE SARTRE	CELESTIN
FRENGER	LYSE
DUTRIAT	SVEN
OSSELAND	SOVANNY
BALLEY	KAFIA
SOBASZEK	BERYL
PORTUGAL	ALLANA
PLACHOT	EMMETT
VOURCH	AMANDO
LECREUX	CARL
SUBTIL	MELITA
SELAME	VINCIENNE
SYLVESTRE-BONCHEVAL	SHAINESSE
DUCHAMBON	ANDRIJA
STRAZZABOSCO	LOAM
MANTELET	MARYA
GEOFROY	ME�LINE
TUDELA	ELIYANA
GRATAIS	CHAYAN
DESCHEMAKER	ARMANTE
FRANCARD	SILVERE
BUGUELLOU	JEREMIE
GOUZENNES	ZAYNE
CORNUCHE	CIEL
DERSON	MIRTHO
VAN DRIESSCHE	LORIANE
DAUZOUT	STEPHANIA
BAIZID	SEVERINA
RUBION	NATY
LASSAULX	MOHAMED-ALI
PUYDT	MAIK
MAESTRAGGI	CORANTHIN
PARDESSUS	M�RIEM
NOUGAOUI	GUILHERME
VEYRET-LOGERIAS	DELIL
CHAPPIS	LISA-MAY
BARBIRATO	EXP�DIT
GRANDCAMP	DANIELA
BENKAHLA	ROLANN
DUCORNETZ	ENCARNACION
FIDINDE	MONCEF
LE CORNU	ELLY
SAACKE	CHAYTON
DENIAU	HILDEGARD
DOUILLARD	A�RIS
GISSET	K�RIM
BEDO	MADIL
D'ACREMONT	MAL�NA
MAURIOL	MARYAM
LAROCHETTE	L�RIA
GUERRERO	KYO
BOUQUANT	ANNIC
CABUY	CHRISLAINE
YU	MIKEL
BOLPAIRE	LOVENSKY
MATHOULIN	MAHAMOUD
ALLAIT	GUNAY
SLATNI	NIVINE
BARRAILLA	JAHNY
ANGAPIN	IHSAN
BOTTOLLIER-LEMALLAZ	ETHANN
DESPERRIES	MALOU
RAMASSOT	LAYAH
FLISSEAU	ADOLINE
COIZY	TAMATOA
BURGART	QUINTINO
BORDAGI	EZRA
STARCK	IZEL
CROZY	DAIANA
RICCOBENE	MARIE-ANGELA
PATRY	JEAN-FRANCO
CHARRUYER	SHARLEEN
LEREVEREND	NICKIE
LEBAHY	ARTHUS
LOKS	ASTAN
DAMEUVE	EMMA-ROSE
MARCHAISON	JAHIN
CESARUS	JOHNA
COULPLE	MELKIOR
PLONEVEZ	MICKEL
GARNI	DOMINO
POILPRE	ARIAN
VERHOEST	NIBRAS
LECHOISNE	SORELLE
GERMANAZ	MACKENSON
OBERKIRCH	KADIDIA
PAILLIARD-TURENNE	LUDINE
CLAUSE	PIERRE-AMAURY
VESCOVACCI	FRANCINET
LARQUET	AREL
TOGNOLA	ANA�K
BOMPA	KOUROSH
GUTIGNY	LOEVANN
CARMELLI	ABELE
APARISI	ODELIA
RAVEAU	ALANIS
OULEVEY	JEAN-POL
BEIN	TIMOTHEY
LEFFE	IOLANDA
RIBAUX	L�ANNE
FIDEL	JULIO
LIVREAU	JILDAZ
BENCHAIBA	LILYAH
BALLER	ANDR�AS
DEMEILLIER	DYCLANE
GAUVILLE	ROZAN
CURTHELEY	THIYA
ROYOUX	ABOUBAKAR
OZEN	PIERRE-ELIOTT
BERTRAND	ANNOUK
VEZINET	KENTARO
ESTEVE	LE�TO
BIQUET	EGISTE
AZELIE	NOLLANN
DROUY	ISLEM
VAUCORET	LOUIS-GUY
ROTHEA	AYED
VAN GHELUE	�NOA
BONDY	JULI
BRIAN	WILANN
YVERNOGEAU	KAYLINE
CHOUX	KAHLAN
MESSAOUR	IANN
AKBARALY	FIDELIO
LENTIN	YILMAZ
MASSOLA	MARIE-ELISE
JOUVANNEAU	ELODI
ABASSEUR	HEMA
RIEANT	ISOBEL
DECARPIGNY	LUCHENZO
WATRY	WILEM
DARSCH	NINOG
BLESY	TAYFUN
GARCIA-ALVAREZ	JANA�L
HEYLBROECK	OUAHIB
GACK	FERDAWS
DUSSARRAT	MOUDJIB
COULONGEAT	DAMIANE
CHASSERAT	CHARLES-AUGUSTE
BLANGER	OLESSIA
PUSSIN	JADHE
HOUVRARD	RYTEJ
DIENG	ZALIHA
MELLOTTEE	IMBERT
BRIZAIS	HANNA
TAGNATI	FILIPPE
LACHOUB	AZIZ
SAINT GERMES	MARTYR
SAUSA	NOLHAN
VESPRES	Y�NA
FLEURAT-LESSARD	LIONELE
KOSICKI	AYLEN
BUCH	HOCHE
BERDU	IO
MARLIO	JOSEF
RENEE	VINCENTE
THERRE	MARWANE
MEGESSIER	LYANDRO
GARIGLIO	OCELLINA
CICERCHIA	S�RGIO
DIMEUX	LYSANDRE
LAVY	DJ�LIKA
SEMION	SOULEYE
BLONDEY	LIVELY
MALBECQ	VINNY
SOUILLOT	ISILD
JEANMET	THYANNA
LAZRAQ	DJENE
CUTTE	WISDOM
DUCOT	AGNESA
DAIGLE	NOHELLA
BARRUE	FRANCIETTE
DEMORO	GYAN
MENEZES	NOAR
ATHENOL	LOUISE-ANNA
WATEAU	TEORA
UHLIG	RATIBA
LAZON	ELVYRE
FIALKOWSKI	KISLEY
WAQUET	�N�LYA
ERENATI	LUDWIK
PATOUREAU	DJORDANE
ONDICOLA	MALWENN
DO CASAL	FILIPPINA
BOUSCAILLOU	OLAYA
PEYPELUT	MILYA
BRUSAU	ZA�AN
ALTINISIK	HAYFA
SOTIROPOULOS	DJIANI
PIERME	IVELYNE
COURTILAT	JIMMY
PASTEY	ASYA
RASSEMONT	DJEIDY
BRARE	WILFRIDA
